111111111111111111111111111111
1P0000000000000000000000000001
101001011111010000100000111001
101001010000010000100001000101
101111011111010000100001000101
101001010000010000100001000101
101001011111011110111100111001
1000000000000000000000000000E1
101111111111111111111111111111
101111111111111111111111111111
100000000000000000000000000001
101001011111010000100000111001
101001010000010000100001000101
1011110111110C0000C0000C000C01
101001010000010000100001000101
101001011111011110111100111001
1000000000000000000000000000E1
111111111111111111111111111111